ADRB2	adrenoceptor beta 2
AKT1	AKT serine/threonine kinase 1
APOE	apolipoprotein E
APP	amyloid beta precursor protein
FAS	Fas cell surface death receptor
ATM	ATM serine/threonine kinase
BDNF	brain derived neurotrophic factor
BRCA1	BRCA1, DNA repair associated
CDKN1A	cyclin dependent kinase inhibitor 1A
CDKN2A	cyclin dependent kinase inhibitor 2A
CFTR	cystic fibrosis transmembrane conductance regulator
CCR5	C-C motif chemokine receptor 5 (gene/pseudogene)
COMT	catechol-O-methyltransferase
CRP	C-reactive protein
CTNNB1	catenin beta 1
CYP2D6	cytochrome P450 family 2 subfamily D member 6
ACE	angiotensin I converting enzyme
ESR1	estrogen receptor 1
F2	coagulation factor II, thrombin
MTOR	mechanistic target of rapamycin
GSTM1	glutathione S-transferase mu 1
GSTP1	glutathione S-transferase pi 1
GSTT1	glutathione S-transferase theta 1
only annotated on alternate loci in reference assembly
HFE	hemochromatosis
HIF1A	hypoxia inducible factor 1 alpha subunit
HLA-A	major histocompatibility complex, class I, A
HLA-DQB1	major histocompatibility complex, class II, DQ beta 1
HLA-DRB1	major histocompatibility complex, class II, DR beta 1
IFNG	interferon gamma
IGF1	insulin like growth factor 1
IL1B	interleukin 1 beta
IL6	interleukin 6
CXCL8	C-X-C motif chemokine ligand 8
IL10	interleukin 10
LEP	leptin
MAPT	microtubule associated protein tau
MMP2	matrix metallopeptidase 2
MTHFR	methylenetetrahydrofolate reductase
NFKB1	nuclear factor kappa B subunit 1
NOS3	nitric oxide synthase 3
NPPB	natriuretic peptide B
SERPINE1	serpin family E member 1
ABCB1	ATP binding cassette subfamily B member 1
PON1	paraoxonase 1
PPARG	peroxisome proliferator activated receptor gamma
MAPK1	mitogen-activated protein kinase 1
PTGS2	prostaglandin-endoperoxide synthase 2
CCL2	C-C motif chemokine ligand 2
SLC6A4	solute carrier family 6 member 4
SNCA	synuclein alpha
SOD1	superoxide dismutase 1
TGFB1	transforming growth factor beta 1
TLR2	toll like receptor 2
TLR4	toll like receptor 4
TNF	tumor necrosis factor
TP53	tumor protein p53
VDR	vitamin D receptor
VEGFA	vascular endothelial growth factor A
XRCC1	X-ray repair cross complementing 1
ADIPOQ	adiponectin, C1Q and collagen domain containing
PARP1	poly(ADP-ribose) polymerase 1
AGER	advanced glycosylation end-product specific receptor
APOA1	apolipoprotein A1
BAX	BCL2 associated X, apoptosis regulator
CASP3	caspase 3
CAV1	caveolin 1
CDKN1B	cyclin dependent kinase inhibitor 1B
MAPK14	mitogen-activated protein kinase 14
CYP3A4	cytochrome P450 family 3 subfamily A member 4
CYP19A1	cytochrome P450 family 19 subfamily A member 1
DRD4	dopamine receptor D4
EDN1	endothelin 1
ESR2	estrogen receptor 2
GSK3B	glycogen synthase kinase 3 beta
CFH	complement factor H
HMGB1	high mobility group box 1
HMOX1	heme oxygenase 1
ICAM1	intercellular adhesion molecule 1
IL1RN	interleukin 1 receptor antagonist
IL18	interleukin 18
INS	insulin
ITGB1	integrin subunit beta 1
LDLR	low density lipoprotein receptor
LPL	lipoprotein lipase
MBL2	mannose binding lectin 2
MET	MET proto-oncogene, receptor tyrosine kinase
NFE2L2	nuclear factor, erythroid 2 like 2
NOS2	nitric oxide synthase 2
NOTCH1	notch 1
MAPK3	mitogen-activated protein kinase 3
PRNP	prion protein
PSEN1	presenilin 1
RELA	RELA proto-oncogene, NF-kB subunit
SLC6A3	solute carrier family 6 member 3
SOD2	superoxide dismutase 2
SP1	Sp1 transcription factor
WT1	Wilms tumor 1
TNFSF10	TNF superfamily member 10
GHRL	ghrelin and obestatin prepropeptide
LRRK2	leucine rich repeat kinase 2
ABCA1	ATP binding cassette subfamily A member 1
ABL1	ABL proto-oncogene 1, non-receptor tyrosine kinase
ALDH2	aldehyde dehydrogenase 2 family (mitochondrial)
APEX1	apurinic/apyrimidinic endodeoxyribonuclease 1
KLK3	kallikrein related peptidase 3
RHOA	ras homolog family member A
BSG	basigin (Ok blood group)
C3	complement C3
RUNX1	runt related transcription factor 1
CD40	CD40 molecule
CD40LG	CD40 ligand
CDK1	cyclin dependent kinase 1
CETP	cholesteryl ester transfer protein
CLU	clusterin
CNR1	cannabinoid receptor 1
CREB1	cAMP responsive element binding protein 1
CST3	cystatin C
CTGF	connective tissue growth factor
CYP17A1	cytochrome P450 family 17 subfamily A member 1
NQO1	NAD(P)H quinone dehydrogenase 1
DNMT1	DNA methyltransferase 1
EGF	epidermal growth factor
FOXO3	forkhead box O3
FMR1	fragile X mental retardation 1
GH1	growth hormone 1
GNAS	GNAS complex locus
GNB3	G protein subunit beta 3
NRG1	neuregulin 1
HSPA4	heat shock protein family A (Hsp70) member 4
HSPA5	heat shock protein family A (Hsp70) member 5
HSP90AA1	heat shock protein 90 alpha family class A member 1
HTR2A	5-hydroxytryptamine receptor 2A
IGF2	insulin like growth factor 2
IL1A	interleukin 1 alpha
IL12B	interleukin 12B
IRS1	insulin receptor substrate 1
ITGAV	integrin subunit alpha V
LCN2	lipocalin 2
MAOA	monoamine oxidase A
MIF	macrophage migration inhibitory factor (glycosylation-inhibiting factor)
MMP3	matrix metallopeptidase 3
MPO	myeloperoxidase
OGG1	8-oxoguanine DNA glycosylase
PRKN	parkin RBR E3 ubiquitin protein ligase
PDCD1	programmed cell death 1
SERPINA1	serpin family A member 1
PLAU	plasminogen activator, urokinase
MAPK8	mitogen-activated protein kinase 8
TIMP1	TIMP metallopeptidase inhibitor 1
TNFRSF1A	TNF receptor superfamily member 1A
TP73	tumor protein p73
TTR	transthyretin
PPARGC1A	PPARG coactivator 1 alpha
CHEK2	checkpoint kinase 2
TARDBP	TAR DNA binding protein
CD274	CD274 molecule
TLR9	toll like receptor 9
HAMP	hepcidin antimicrobial peptide
NLRP3	NLR family pyrin domain containing 3
MIR146A	microRNA 146a
hsa-mir-146	hsa-mir-146a
ADRB1	adrenoceptor beta 1
APOC3	apolipoprotein C3
CALR	calreticulin
CBS	cystathionine-beta-synthase
CD36	CD36 molecule
CHEK1	checkpoint kinase 1
CHI3L1	chitinase 3 like 1
DRD3	dopamine receptor D3
EGR1	early growth response 1
ERG	ERG, ETS transcription factor
FGB	fibrinogen beta chain
FYN	FYN proto-oncogene, Src family tyrosine kinase
G6PD	glucose-6-phosphate dehydrogenase
GRN	granulin precursor
HP	haptoglobin
HTR1A	5-hydroxytryptamine receptor 1A
LRP1	LDL receptor related protein 1
LTF	lactotransferrin
NOS1	nitric oxide synthase 1
NOTCH3	notch 3
P2RX7	purinergic receptor P2X 7
PIN1	peptidylprolyl cis/trans isomerase, NIMA-interacting 1
PLAT	plasminogen activator, tissue type
PLG	plasminogen
RAF1	Raf-1 proto-oncogene, serine/threonine kinase
S100A9	S100 calcium binding protein A9
S100B	S100 calcium binding protein B
SELP	selectin P
STK11	serine/threonine kinase 11
TGFBR2	transforming growth factor beta receptor 2
TNFRSF1B	TNF receptor superfamily member 1B
TNNI3	troponin I3, cardiac type
BECN1	beclin 1
SQSTM1	sequestosome 1
SOCS3	suppressor of cytokine signaling 3
YAP1	Yes associated protein 1
HPSE	heparanase
DKK1	dickkopf WNT signaling pathway inhibitor 1
BACE1	beta-secretase 1
CCR2	C-C motif chemokine receptor 2
ADH1B	alcohol dehydrogenase 1B (class I), beta polypeptide
ADORA2A	adenosine A2a receptor
ALOX5	arachidonate 5-lipoxygenase
AQP1	aquaporin 1 (Colton blood group)
AQP4	aquaporin 4
AVP	arginine vasopressin
BCHE	butyrylcholinesterase
CACNA1C	calcium voltage-gated channel subunit alpha1 C
CAT	catalase
SCARB1	scavenger receptor class B member 1
CDKN2B	cyclin dependent kinase inhibitor 2B
CHGA	chromogranin A
CHRNA7	cholinergic receptor nicotinic alpha 7 subunit
CRYAB	crystallin alpha B
CTSB	cathepsin B
CTSD	cathepsin D
CX3CR1	C-X3-C motif chemokine receptor 1
CYBB	cytochrome b-245 beta chain
DNMT3A	DNA methyltransferase 3 alpha
DNMT3B	DNA methyltransferase 3 beta
F13A1	coagulation factor XIII A chain
FSHR	follicle stimulating hormone receptor
FUS	FUS RNA binding protein
GAPDH	glyceraldehyde-3-phosphate dehydrogenase
GLI1	GLI family zinc finger 1
HDAC2	histone deacetylase 2
HTR2C	5-hydroxytryptamine receptor 2C
IAPP	islet amyloid polypeptide
IL6R	interleukin 6 receptor
CXCR2	C-X-C motif chemokine receptor 2
IL12A	interleukin 12A
ITGAM	integrin subunit alpha M
LIPC	lipase C, hepatic type
MME	membrane metalloendopeptidase
MMP13	matrix metallopeptidase 13
MUTYH	mutY DNA glycosylase
NCAM1	neural cell adhesion molecule 1
NGF	nerve growth factor
NGFR	nerve growth factor receptor
NPY	neuropeptide Y
NTRK1	neurotrophic receptor tyrosine kinase 1
NTRK2	neurotrophic receptor tyrosine kinase 2
OLR1	oxidized low density lipoprotein receptor 1
PDGFB	platelet derived growth factor subunit B
SERPINF1	serpin family F member 1
MAP2K1	mitogen-activated protein kinase kinase 1
EIF2AK2	eukaryotic translation initiation factor 2 alpha kinase 2
RPS6KB1	ribosomal protein S6 kinase B1
RXRA	retinoid X receptor alpha
SHBG	sex hormone binding globulin
ADAM17	ADAM metallopeptidase domain 17
TF	transferrin
TIMP2	TIMP metallopeptidase inhibitor 2
TSC2	tuberous sclerosis 2
TXN	thioredoxin
UCHL1	ubiquitin C-terminal hydrolase L1
VCP	valosin containing protein
YWHAZ	tyrosine 3-monooxygenase/tryptophan 5-monooxygenase activation protein zeta
TPH2	tryptophan hydroxylase 2
C9orf72	chromosome 9 open reading frame 72
A2M	alpha-2-macroglobulin
ACHE	acetylcholinesterase (Cartwright blood group)
ADAM10	ADAM metallopeptidase domain 10
ADAR	adenosine deaminase, RNA specific
ALPL	alkaline phosphatase, liver/bone/kidney
ARRB2	arrestin beta 2
BLM	Bloom syndrome RecQ like helicase
CDH2	cadherin 2
CDK5	cyclin dependent kinase 5
CR1	complement C3b/C4b receptor 1 (Knops blood group)
CRHR1	corticotropin releasing hormone receptor 1
CSF1	colony stimulating factor 1
CSF2	colony stimulating factor 2
DBH	dopamine beta-hydroxylase
DRD1	dopamine receptor D1
EDNRB	endothelin receptor type B
PTK2B	protein tyrosine kinase 2 beta
GFAP	glial fibrillary acidic protein
GRIN2B	glutamate ionotropic receptor NMDA type subunit 2B
GSN	gelsolin
HMGA1	high mobility group AT-hook 1
IL6ST	interleukin 6 signal transducer
STMN1	stathmin 1
LHCGR	luteinizing hormone/choriogonadotropin receptor
PLA2G2A	phospholipase A2 group IIA
HTRA1	HtrA serine peptidase 1
PTCH1	patched 1
PTGS1	prostaglandin-endoperoxide synthase 1
RAN	RAN, member RAS oncogene family
SAA1	serum amyloid A1
CCL3	C-C motif chemokine ligand 3
TBP	TATA-box binding protein
THRB	thyroid hormone receptor beta
TPH1	tryptophan hydroxylase 1
XBP1	X-box binding protein 1
CLOCK	clock circadian regulator
STUB1	STIP1 homology and U-box containing protein 1
IKZF1	IKAROS family zinc finger 1
RACK1	receptor for activated C kinase 1
COL18A1	collagen type XVIII alpha 1 chain
SERPINA3	serpin family A member 3
ALOX15	arachidonate 15-lipoxygenase
BIRC3	baculoviral IAP repeat containing 3
ATF4	activating transcription factor 4
BDKRB2	bradykinin receptor B2
CASP1	caspase 1
CHRNA3	cholinergic receptor nicotinic alpha 3 subunit
CHRNA4	cholinergic receptor nicotinic alpha 4 subunit
CNR2	cannabinoid receptor 2
CP	ceruloplasmin
CRH	corticotropin releasing hormone
CSF3	colony stimulating factor 3
CTSL	cathepsin L
DAPK1	death associated protein kinase 1
DEFB1	defensin beta 1
DNM2	dynamin 2
EEF1A1	eukaryotic translation elongation factor 1 alpha 1
EIF2S1	eukaryotic translation initiation factor 2 subunit alpha
ENO1	enolase 1
ENO2	enolase 2
FANCD2	Fanconi anemia complementation group D2
FGF1	fibroblast growth factor 1
FOLH1	folate hydrolase 1
GRIN1	glutamate ionotropic receptor NMDA type subunit 1
HMGCR	3-hydroxy-3-methylglutaryl-CoA reductase
FOXA1	forkhead box A1
HNRNPA1	heterogeneous nuclear ribonucleoprotein A1
IDE	insulin degrading enzyme
LOX	lysyl oxidase
LOXL1	lysyl oxidase like 1
MAOB	monoamine oxidase B
MBP	myelin basic protein
NFATC1	nuclear factor of activated T-cells 1
NPC1	NPC intracellular cholesterol transporter 1
PAX2	paired box 2
PAX3	paired box 3
PLA2G4A	phospholipase A2 group IVA
POLB	DNA polymerase beta
PON2	paraoxonase 2
RELN	reelin
PSEN2	presenilin 2
RAB5A	RAB5A, member RAS oncogene family
CCL11	C-C motif chemokine ligand 11
SMPD1	sphingomyelin phosphodiesterase 1
SNAP25	synaptosome associated protein 25
SORL1	sortilin related receptor 1
In some of the published literature, this gene has been incorrectly associated with the LRP9 alias, but the LRP9 alias more correctly refers to Gene ID 26020, LRP10. [05 May 2010]
SSTR2	somatostatin receptor 2
VDAC1	voltage dependent anion channel 1
HIST3H3	histone cluster 3 H3
IL32	interleukin 32
DNM1L	dynamin 1 like
KAT5	lysine acetyltransferase 5
PROCR	protein C receptor
SIRT3	sirtuin 3
SLC40A1	solute carrier family 40 member 1
TREM1	triggering receptor expressed on myeloid cells 1
ARMS2	age-related maculopathy susceptibility 2
MIR223	microRNA 223
hsa-mir-223
MIR27A	microRNA 27a
hsa-mir-27a
MIR29A	microRNA 29a
microRNA 29
ADCYAP1	adenylate cyclase activating polypeptide 1
ALOX12	arachidonate 12-lipoxygenase, 12S type
BIN1	bridging integrator 1
ANPEP	alanyl aminopeptidase, membrane
APOC1	apolipoprotein C1
BAG1	BCL2 associated athanogene 1
C4A	complement C4A (Rodgers blood group)
C5AR1	complement C5a receptor 1
CAPN1	calpain 1
CHRM2	cholinergic receptor muscarinic 2
CCR3	C-C motif chemokine receptor 3
CTSS	cathepsin S
DLG4	discs large MAGUK scaffold protein 4
DYRK1A	dual specificity tyrosine phosphorylation regulated kinase 1A
ELK1	ELK1, ETS transcription factor
FAAH	fatty acid amide hydrolase
FABP3	fatty acid binding protein 3
GRIN2A	glutamate ionotropic receptor NMDA type subunit 2A
HCRT	hypocretin neuropeptide precursor
HLA-DRB5	major histocompatibility complex, class II, DR beta 5
HNRNPA2B1	heterogeneous nuclear ribonucleoprotein A2/B1
HSPG2	heparan sulfate proteoglycan 2
ITPR1	inositol 1,4,5-trisphosphate receptor type 1
KNG1	kininogen 1
LRP6	LDL receptor related protein 6
CXCL9	C-X-C motif chemokine ligand 9
MMP12	matrix metallopeptidase 12
NEFL	neurofilament light
NOTCH4	notch 4
OXT	oxytocin/neurophysin I prepropeptide
RFC1	replication factor C subunit 1
S100A7	S100 calcium binding protein A7
SET	SET nuclear proto-oncogene
SLC1A2	solute carrier family 1 member 2
UBB	ubiquitin B
PDCD6IP	programmed cell death 6 interacting protein
DKK3	dickkopf WNT signaling pathway inhibitor 3
TREM2	triggering receptor expressed on myeloid cells 2
SLC2A9	solute carrier family 2 member 9
DAOA	D-amino acid oxidase activator
BMP6	bone morphogenetic protein 6
CAMK2A	calcium/calmodulin dependent protein kinase II alpha
CAPN2	calpain 2
CASP2	caspase 2
CASP6	caspase 6
CHAT	choline O-acetyltransferase
RCAN1	regulator of calcineurin 1
ECE1	endothelin converting enzyme 1
FKBP1A	FK506 binding protein 1A
GAD1	glutamate decarboxylase 1
GAD2	glutamate decarboxylase 2
GLB1	galactosidase beta 1
GSK3A	glycogen synthase kinase 3 alpha
HEXB	hexosaminidase subunit beta
IGH	immunoglobulin heavy locus
D (diversity) region of heavy chains	J (joining) region of heavy chains	immunglobulin heavy chain variable region	immunoglobulin heavy diversity cluster	immunoglobulin heavy diversity group	immunoglobulin heavy diversity locus	immunoglobulin heavy joining cluster	immunoglobulin heavy joining group	immunoglobulin heavy polypeptide, joining region	immunoglobulin heavy variable cluster	immunoglobulin heavy variable group
IL3	interleukin 3
KCNA3	potassium voltage-gated channel subfamily A member 3
KLK1	kallikrein 1
LRP2	LDL receptor related protein 2
MEF2A	myocyte enhancer factor 2A
MEF2C	myocyte enhancer factor 2C
MSR1	macrophage scavenger receptor 1
MTHFD1	methylenetetrahydrofolate dehydrogenase, cyclohydrolase and formyltetrahydrofolate synthetase 1
NEDD9	neural precursor cell expressed, developmentally down-regulated 9
OPRD1	opioid receptor delta 1
P2RY2	purinergic receptor P2Y2
PAK2	p21 (RAC1) activated kinase 2
PAWR	pro-apoptotic WT1 regulator
PDYN	prodynorphin
PLD2	phospholipase D2
PLTP	phospholipid transfer protein
PRKAB1	protein kinase AMP-activated non-catalytic subunit beta 1
MAP2K2	mitogen-activated protein kinase kinase 2
PTGDS	prostaglandin D2 synthase
PTGER2	prostaglandin E receptor 2
RGS4	regulator of G protein signaling 4
RORA	RAR related orphan receptor A
SORT1	sortilin 1
S100A12	S100 calcium binding protein A12
SCD	stearoyl-CoA desaturase
TRPM2	transient receptor potential cation channel subfamily M member 2
NR1H2	nuclear receptor subfamily 1 group H member 2
RAB7A	RAB7A, member RAS oncogene family
EIF2AK3	eukaryotic translation initiation factor 2 alpha kinase 3
PTGES	prostaglandin E synthase
ABCG1	ATP binding cassette subfamily G member 1
GAB2	GRB2 associated binding protein 2
SIGMAR1	sigma non-opioid intracellular receptor 1
KLF2	Kruppel like factor 2
SEMA3A	semaphorin 3A
SIRT2	sirtuin 2
NCSTN	nicastrin
HTRA2	HtrA serine peptidase 2
GAL	galanin and GMAP prepropeptide
CYCS	cytochrome c, somatic
MIR124-1	microRNA 124-1
hsa-mir-124-1	hsa-mir-124a-1	microRNA 124a-1
MIR125A	microRNA 125a
hsa-mir-125a
MIR125B1	microRNA 125b-1
hsa-mir-125b-1
MIR375	microRNA 375
CDKN2B-AS1	CDKN2B antisense RNA 1
CDKN2B antisense RNA 1 (non-protein coding)	antisense noncoding RNA in the INK4 locus	p15 antisense RNA	prostate cancer associated transcript 12
ANK3	ankyrin 3
APCS	amyloid P component, serum
APOD	apolipoprotein D
BCL3	B-cell CLL/lymphoma 3
CAST	calpastatin
CHRNB2	cholinergic receptor nicotinic beta 2 subunit
DRD5	dopamine receptor D5
GRM5	glutamate metabotropic receptor 5
HK1	hexokinase 1
FOXA2	forkhead box A2
HRH1	histamine receptor H1
HTR4	5-hydroxytryptamine receptor 4
INPP5D	inositol polyphosphate-5-phosphatase D
MAP2	microtubule associated protein 2
SLC11A2	solute carrier family 11 member 2
NTS	neurotensin
PPP3CA	protein phosphatase 3 catalytic subunit alpha
KLK6	kallikrein related peptidase 6
RPS6	ribosomal protein S6
SFPQ	splicing factor proline and glutamine rich
SLC8A1	solute carrier family 8 member A1
SLC18A2	solute carrier family 18 member A2
SST	somatostatin
SULT2A1	sulfotransferase family 2A member 1
VLDLR	very low density lipoprotein receptor
PICALM	phosphatidylinositol binding clathrin assembly protein
GSTO1	glutathione S-transferase omega 1
PRDX6	peroxiredoxin 6
TOMM40	translocase of outer mitochondrial membrane 40
ESM1	endothelial cell specific molecule 1
NLRP1	NLR family pyrin domain containing 1
WWC1	WW and C2 domain containing 1
CNTNAP2	contactin associated protein-like 2
HSPB8	heat shock protein family B (small) member 8
UBQLN1	ubiquilin 1
GOLM1	golgi membrane protein 1
NGB	neuroglobin
HRH4	histamine receptor H4
PPP1R1B	protein phosphatase 1 regulatory inhibitor subunit 1B
MIR100	microRNA 100
hsa-mir-100
ADARB1	adenosine deaminase, RNA specific B1
APBB1	amyloid beta precursor protein binding family B member 1
ARSB	arylsulfatase B
ATP5A1	ATP synthase, H+ transporting, mitochondrial F1 complex, alpha subunit 1, cardiac muscle
BACH1	BTB domain and CNC homolog 1
CAMK4	calcium/calmodulin dependent protein kinase IV
CD33	CD33 molecule
CKB	creatine kinase B
SLC31A1	solute carrier family 31 member 1
CSNK1D	casein kinase 1 delta
DHCR24	24-dehydrocholesterol reductase
DPYSL2	dihydropyrimidinase like 2
FKBP4	FK506 binding protein 4
GLRX	glutaredoxin
GLUL	glutamate-ammonia ligase
HSD17B10	hydroxysteroid 17-beta dehydrogenase 10
HMOX2	heme oxygenase 2
HNMT	histamine N-methyltransferase
HRH2	histamine receptor H2
HTR6	5-hydroxytryptamine receptor 6
IREB2	iron responsive element binding protein 2
KRT9	keratin 9
LNPEP	leucyl and cystinyl aminopeptidase
BCAM	basal cell adhesion molecule (Lutheran blood group)
MTNR1A	melatonin receptor 1A
NQO2	N-ribosyldihydronicotinamide:quinone reductase 2
PNP	purine nucleoside phosphorylase
P2RX4	purinergic receptor P2X 4
PMCH	pro-melanin concentrating hormone
PURA	purine rich element binding protein A
PVR	poliovirus receptor
SLC2A3	solute carrier family 2 member 3
SNRNP70	small nuclear ribonucleoprotein U1 subunit 70
SYP	synaptophysin
TP53BP2	tumor protein p53 binding protein 2
ZYX	zyxin
LRP8	LDL receptor related protein 8
DDX39B	DExD-box helicase 39B
NRIP1	nuclear receptor interacting protein 1
SOCS2	suppressor of cytokine signaling 2
CDK5R1	cyclin dependent kinase 5 regulatory subunit 1
CARTPT	CART prepropeptide
AKAP9	A-kinase anchoring protein 9
FLOT1	flotillin 1
LILRB2	leukocyte immunoglobulin like receptor B2
PEMT	phosphatidylethanolamine N-methyltransferase
SEMA4D	semaphorin 4D
NPC2	NPC intracellular cholesterol transporter 2
CELF1	CUGBP Elav-like family member 1
PTGES3	prostaglandin E synthase 3
CYP46A1	cytochrome P450 family 46 subfamily A member 1
CARD8	caspase recruitment domain family member 8
SETX	senataxin
CD2AP	CD2 associated protein
SMURF1	SMAD specific E3 ubiquitin protein ligase 1
TET1	tet methylcytosine dioxygenase 1
SYVN1	synoviolin 1
MIR107	microRNA 107
hsa-mir-107
MIR132	microRNA 132
hsa-mir-132
MIR29B1	microRNA 29b-1
hsa-mir-29b-1
APLP2	amyloid beta precursor like protein 2
ZFHX3	zinc finger homeobox 3
C1R	complement C1r
This gene aligns across a gap in the GRCh38 reference genome assembly, and therefore, the 5' end of this gene was annotated on NT_009714.18 and the 3' end was annotated on NT_009759.17 in NCBI's Homo sapiens Annotation Release 106. [29 Jun 2015]	suggests misassembly
CASP4	caspase 4
CHGB	chromogranin B
CPE	carboxypeptidase E
CTNND2	catenin delta 2
EPHA1	EPH receptor A1
GRIN2C	glutamate ionotropic receptor NMDA type subunit 2C
HCRTR1	hypocretin receptor 1
HCRTR2	hypocretin receptor 2
AFF1	AF4/FMR2 family member 1
PCK1	phosphoenolpyruvate carboxykinase 1
PCMT1	protein-L-isoaspartate (D-aspartate) O-methyltransferase
PCSK5	proprotein convertase subtilisin/kexin type 5
SERPINI1	serpin family I member 1
PLOD1	procollagen-lysine,2-oxoglutarate 5-dioxygenase 1
PPID	peptidylprolyl isomerase D
This gene encodes a 370 aa protein that is found in the cytoplasm. In some databases, it has been labeled incorrectly as 'cyclophilin D'. This same name has also been applied to a different protein, found in the mitochondrion, which is represented by Entrez GeneID 10105, PPIF. [13 Feb 2013]
NECTIN2	nectin cell adhesion molecule 2
ITSN1	intersectin 1
SOAT1	sterol O-acyltransferase 1
ACAT1 (GeneID 38) and SOAT1 (GeneID 6646) loci share the ACAT1 symbol/alias in common. ACAT1 is widely used alternative name for acyl-Coenzyme A: cholesterol acyltransferase 1 (SOAT1) conflicting with the official symbol for acetyl-Coenzyme A acetyltransferase 1 (acetoacetyl Coenzyme A thiolase) (ACAT1). [13 Feb 2013]
THBS4	thrombospondin 4
VSNL1	visinin like 1
CUBN	cubilin
WASF1	WAS protein family member 1
LRAT	lecithin retinol acyltransferase (phosphatidylcholine--retinol O-acyltransferase)
CYP7B1	cytochrome P450 family 7 subfamily B member 1
ITM2B	integral membrane protein 2B
MAPK8IP1	mitogen-activated protein kinase 8 interacting protein 1
CIB1	calcium and integrin binding 1
HRH3	histamine receptor H3
BACE2	beta-site APP-cleaving enzyme 2
APPL1	adaptor protein, phosphotyrosine interacting with PH domain and leucine zipper 1
GGA1	golgi associated, gamma adaptin ear containing, ARF binding protein 1
KCNIP3	potassium voltage-gated channel interacting protein 3
DDIT4	DNA damage inducible transcript 4
PSENEN	presenilin enhancer gamma-secretase subunit
KIR2DL5A	killer cell immunoglobulin like receptor, two Ig domains and long cytoplasmic tail 5A
only annotated on alternate loci in reference assembly
CSMD1	CUB and Sushi multiple domains 1
RTN4R	reticulon 4 receptor
ACO2	aconitase 2
AP2A2	adaptor related protein complex 2 alpha 2 subunit
ALAS1	5'-aminolevulinate synthase 1
BLMH	bleomycin hydrolase
BLVRA	biliverdin reductase A
CFL2	cofilin 2
CHN1	chimerin 1
CISH	cytokine inducible SH2 containing protein
ACKR2	atypical chemokine receptor 2
DBN1	drebrin 1
ELAVL4	ELAV like RNA binding protein 4
BPTF	bromodomain PHD finger transcription factor
GPC1	glypican 1
GRM2	glutamate metabotropic receptor 2
GSTA4	glutathione S-transferase alpha 4
IL1RAP	interleukin 1 receptor accessory protein
KLC1	kinesin light chain 1
MELTF	melanotransferrin
NRGN	neurogranin
PPP3R1	protein phosphatase 3 regulatory subunit B, alpha
PSMA1	proteasome subunit alpha 1
RYR3	ryanodine receptor 3
CCL15	C-C motif chemokine ligand 15
SOX5	SRY-box 5
TACR2	tachykinin receptor 2
TFCP2	transcription factor CP2
MADD	MAP kinase activating death domain
PDE8B	phosphodiesterase 8B
ADAM19	ADAM metallopeptidase domain 19
CACNA1G	calcium voltage-gated channel subunit alpha1 G
KALRN	kalirin RhoGEF kinase
SLC28A1	solute carrier family 28 member 1
NRXN3	neurexin 3
NCR2	natural cytotoxicity triggering receptor 2
HOMER1	homer scaffolding protein 1
ELMO1	engulfment and cell motility 1
RTN3	reticulon 3
ABCA7	ATP binding cassette subfamily A member 7
FERMT2	fermitin family member 2
GGA3	golgi associated, gamma adaptin ear containing, ARF binding protein 3
SASH1	SAM and SH3 domain containing 1
NCS1	neuronal calcium sensor 1
PRND	prion like protein doppel
PPP1R15A	protein phosphatase 1 regulatory subunit 15A
C5AR2	complement component 5a receptor 2
CTNNA3	catenin alpha 3
PARVB	parvin beta
FIS1	fission, mitochondrial 1
SH3GLB1	SH3 domain containing GRB2 like, endophilin B1
APH1A	aph-1 homolog A, gamma-secretase subunit
CDK5RAP2	CDK5 regulatory subunit associated protein 2
CAND1	cullin associated and neddylation dissociated 1
ADAMTS9	ADAM metallopeptidase with thrombospondin type 1 motif 9
DERL1	derlin 1
DNAJC5	DnaJ heat shock protein family (Hsp40) member C5
CNTN4	contactin 4
CALHM1	calcium homeostasis modulator 1
AGRN	agrin
MIR212	microRNA 212
hsa-mir-212
MIR302A	microRNA 302a
hsa-mir-302a	microRNA 302
ABCA2	ATP binding cassette subfamily A member 2
ADCY8	adenylate cyclase 8
APBA1	amyloid beta precursor protein binding family A member 1
APBA2	amyloid beta precursor protein binding family A member 2
CCNC	cyclin C
COX4I1	cytochrome c oxidase subunit 4I1
EFNA5	ephrin A5
FRK	fyn related Src family tyrosine kinase
ME2	malic enzyme 2
MGAT3	mannosyl (beta-1,4-)-glycoprotein beta-1,4-N-acetylglucosaminyltransferase
NUCB1	nucleobindin 1
PGAM1	phosphoglycerate mutase 1
POU4F1	POU class 4 homeobox 1
RFC3	replication factor C subunit 3
SP4	Sp4 transcription factor
VGF	VGF nerve growth factor inducible
MZF1	myeloid zinc finger 1
CHAF1B	chromatin assembly factor 1 subunit B
CRADD	CASP2 and RIPK1 domain containing adaptor with death domain
DOK2	docking protein 2
NPEPPS	aminopeptidase puromycin sensitive
MAGI2	membrane associated guanylate kinase, WW and PDZ domain containing 2
CELF2	CUGBP Elav-like family member 2
TMED10	transmembrane p24 trafficking protein 10
STMN2	stathmin 2
QPCT	glutaminyl-peptide cyclotransferase
MTHFD1L	methylenetetrahydrofolate dehydrogenase (NADP+ dependent) 1-like
GLS2	glutaminase 2
SLC39A1	solute carrier family 39 member 1
RGCC	regulator of cell cycle
PLA2G3	phospholipase A2 group III
TMEM106B	transmembrane protein 106B
SMPD3	sphingomyelin phosphodiesterase 3
KIDINS220	kinase D interacting substrate 220
DEPTOR	DEP domain containing MTOR interacting protein
FTMT	ferritin mitochondrial
TP53INP1	tumor protein p53 inducible nuclear protein 1
KCNV2	potassium voltage-gated channel modifier subfamily V member 2
STH	saitohin
SGMS1	sphingomyelin synthase 1
ALDOC	aldolase, fructose-bisphosphate C
CORT	cortistatin
COX10	COX10, heme A:farnesyltransferase cytochrome c oxidase assembly factor
CTNNA2	catenin alpha 2
DOCK2	dedicator of cytokinesis 2
GFRA2	GDNF family receptor alpha 2
MAN2A1	mannosidase alpha class 2A member 1
MEOX2	mesenchyme homeobox 2
MLN	motilin
PLXNA1	plexin A1
PPP1R10	protein phosphatase 1 regulatory subunit 10
ALDH18A1	aldehyde dehydrogenase 18 family member A1
PZP	PZP, alpha-2-macroglobulin like
RPN2	ribophorin II
ATXN8OS	ATXN8 opposite strand (non-protein coding)
ataxin 8 opposite strand	kelch-like 1 antisense	non-protein coding RNA 3
SLC8A3	solute carrier family 8 member A3
SOS2	SOS Ras/Rho guanine nucleotide exchange factor 2
TNFAIP1	TNF alpha induced protein 1
SLC30A1	solute carrier family 30 member 1
SLC30A4	solute carrier family 30 member 4
MAPKAPK5	mitogen-activated protein kinase-activated protein kinase 5
DNAH11	dynein axonemal heavy chain 11
HRK	harakiri, BCL2 interacting protein
NAE1	NEDD8 activating enzyme E1 subunit 1
DLGAP1	DLG associated protein 1
SLC25A27	solute carrier family 25 member 27
STX8	syntaxin 8
ECE2	endothelin converting enzyme 2
SNAP91	synaptosome associated protein 91
TOM1	target of myb1 membrane trafficking protein
SPON1	spondin 1
ADAP1	ArfGAP with dual PH domains 1
RRAS2	related RAS viral (r-ras) oncogene homolog 2
PAXIP1	PAX interacting protein 1
PDS5B	PDS5 cohesin associated factor B
ARC	activity regulated cytoskeleton associated protein
ADNP	activity dependent neuroprotector homeobox
LDOC1	LDOC1, regulator of NFKB signaling
PCDH11X	protocadherin 11 X-linked
PCSK1N	proprotein convertase subtilisin/kexin type 1 inhibitor
SOCS7	suppressor of cytokine signaling 7
RASD1	ras related dexamethasone induced 1
SLC30A10	solute carrier family 30 member 10
FRMD4A	FERM domain containing 4A
ANKS1B	ankyrin repeat and sterile alpha motif domain containing 1B
DUSP22	dual specificity phosphatase 22
MARK4	microtubule affinity regulating kinase 4
EXOC4	exocyst complex component 4
ZBP1	Z-DNA binding protein 1
PCDH11Y	protocadherin 11 Y-linked
TLN2	talin 2
COL25A1	collagen type XXV alpha 1 chain
PTPN5	protein tyrosine phosphatase, non-receptor type 5
CHRFAM7A	CHRNA7 (exons 5-10) and FAM7A (exons A-E) fusion
SORCS1	sortilin related VPS10 domain containing receptor 1
MPP7	membrane palmitoylated protein 7
ARID2	AT-rich interaction domain 2
STOX1	storkhead box 1
TGM6	transglutaminase 6
CISD2	CDGSH iron sulfur domain 2
APBB2	amyloid beta precursor protein binding family B member 2
SEPT1	septin 1
GABRG3	gamma-aminobutyric acid type A receptor gamma3 subunit
ITPKB	inositol-trisphosphate 3-kinase B
NINJ2	ninjurin 2
OGDH	oxoglutarate dehydrogenase
RNPEP	arginyl aminopeptidase
VAMP1	vesicle associated membrane protein 1
CCRL2	C-C motif chemokine receptor like 2
APBA3	amyloid beta precursor protein binding family A member 3
ACAP1	ArfGAP with coiled-coil, ankyrin repeat and PH domains 1
GPC6	glypican 6
PITRM1	pitrilysin metallopeptidase 1
SCGN	secretagogin, EF-hand calcium binding protein
CDC42EP3	CDC42 effector protein 3
PDIA5	protein disulfide isomerase family A member 5
CLSTN1	calsyntenin 1
DNMBP	dynamin binding protein
QPRT	quinolinate phosphoribosyltransferase
PLD3	phospholipase D family member 3
PDE7B	phosphodiesterase 7B
UTP20	UTP20, small subunit processome component
SCG3	secretogranin III
SAR1B	secretion associated Ras related GTPase 1B
ACKR4	atypical chemokine receptor 4
LIMS2	LIM zinc finger domain containing 2
FMN2	formin 2
SLC17A7	solute carrier family 17 member 7
MMEL1	membrane metalloendopeptidase like 1
PPP1R3B	protein phosphatase 1 regulatory subunit 3B
RNF146	ring finger protein 146
MEGF10	multiple EGF like domains 10
AZIN2	antizyme inhibitor 2
MAL2	mal, T-cell differentiation protein 2 (gene/pseudogene)
CCDC50	coiled-coil domain containing 50
SLC2A12	solute carrier family 2 member 12
PRUNE2	prune homolog 2
GLIS3	GLIS family zinc finger 3
SLC9A9	solute carrier family 9 member A9
C21orf2	chromosome 21 open reading frame 2
MS4A3	membrane spanning 4-domains A3
CDR1	cerebellar degeneration related protein 1
COX15	COX15, cytochrome c oxidase assembly homolog
CYB561	cytochrome b561
DMXL1	Dmx like 1
GPR3	G protein-coupled receptor 3
MGST3	microsomal glutathione S-transferase 3
MOBP	myelin-associated oligodendrocyte basic protein
NCAM2	neural cell adhesion molecule 2
CDK17	cyclin dependent kinase 17
CDK18	cyclin dependent kinase 18
S100A5	S100 calcium binding protein A5
SUCLG2	succinate-CoA ligase GDP-forming beta subunit
PIGQ	phosphatidylinositol glycan anchor biosynthesis class Q
SCAF11	SR-related CTD associated factor 11
TRIP4	thyroid hormone receptor interactor 4
SLC4A8	solute carrier family 4 member 8
SCAMP1	secretory carrier membrane protein 1
ZNF592	zinc finger protein 592
ST18	ST18, C2H2C-type zinc finger
HS3ST1	heparan sulfate-glucosamine 3-sulfotransferase 1
FARP1	FERM, ARH/RhoGEF and pleckstrin domain protein 1
ATP5H	ATP synthase, H+ transporting, mitochondrial Fo complex subunit D
APPBP2	amyloid beta precursor protein binding protein 2
ARPP19	cAMP regulated phosphoprotein 19
SORCS3	sortilin related VPS10 domain containing receptor 3
MYO16	myosin XVI
HECW1	HECT, C2 and WW domain containing E3 ubiquitin protein ligase 1
PRRC2C	proline rich coiled-coil 2C
ASTN2	astrotactin 2
TSPAN13	tetraspanin 13
SLC2A8	solute carrier family 2 member 8
NRN1	neuritin 1
NME8	NME/NM23 family member 8
DCHS2	dachsous cadherin-related 2
BCAS3	BCAS3, microtubule associated cell migration factor
UBE2Q1	ubiquitin conjugating enzyme E2 Q1
SLC30A6	solute carrier family 30 member 6
CMAS	cytidine monophosphate N-acetylneuraminic acid synthetase
TSHZ3	teashirt zinc finger homeobox 3
SAP30L	SAP30 like
RIN3	Ras and Rab interactor 3
TTBK1	tau tubulin kinase 1
SPPL2A	signal peptide peptidase like 2A
PLXNA4	plexin A4
FRMD6	FERM domain containing 6
SOCS4	suppressor of cytokine signaling 4
SLC24A4	solute carrier family 24 member 4
MRPL10	mitochondrial ribosomal protein L10
NDUFAF6	NADH:ubiquinone oxidoreductase complex assembly factor 6
CACUL1	CDK2 associated cullin domain 1
NKAIN2	sodium/potassium transporting ATPase interacting 2
TUSC1	tumor suppressor candidate 1
KCNT2	potassium sodium-activated channel subfamily T member 2
LRRTM3	leucine rich repeat transmembrane neuronal 3
MIR103A1	microRNA 103a-1
hsa-mir-103-1	hsa-mir-103a-1	microRNA 103-1
MIR603	microRNA 603
FAM72A	family with sequence similarity 72 member A
BACE1-AS	BACE1 antisense RNA
BACE1 antisense RNA (non-protein coding)
SLC8A2	solute carrier family 8 member A2
APBB3	amyloid beta precursor protein binding family B member 3
ARPP21	cAMP regulated phosphoprotein 21
ZPBP	zona pellucida binding protein
DIP2C	disco interacting protein 2 homolog C
ZNF292	zinc finger protein 292
EFR3A	EFR3 homolog A
UBXN4	UBX domain protein 4
NPTXR	neuronal pentraxin receptor
KCTD2	potassium channel tetramerization domain containing 2
PPIL2	peptidylprolyl isomerase like 2
BZW2	basic leucine zipper and W2 domains 2
STXBP6	syntaxin binding protein 6
SNX12	sorting nexin 12
GSAP	gamma-secretase activating protein
STK32B	serine/threonine kinase 32B
CASS4	Cas scaffolding protein family member 4
ALPK3	alpha kinase 3
ARHGAP20	Rho GTPase activating protein 20
NEUROD6	neuronal differentiation 6
MS4A6A	membrane spanning 4-domains A6A
ANKRD55	ankyrin repeat domain 55
CLMN	calmin
TREML2	triggering receptor expressed on myeloid cells like 2
ADAMTS20	ADAM metallopeptidase with thrombospondin type 1 motif 20
TM2D1	TM2 domain containing 1
DCUN1D5	defective in cullin neddylation 1 domain containing 5
EXOC3L2	exocyst complex component 3 like 2
OSBPL7	oxysterol binding protein like 7
LRRC15	leucine rich repeat containing 15
HECTD2	HECT domain E3 ubiquitin protein ligase 2
CLVS1	clavesin 1
SLC10A4	solute carrier family 10 member 4
LEMD2	LEM domain containing 2
UTS2B	urotensin 2B
ZNF326	zinc finger protein 326
C20orf203	chromosome 20 open reading frame 203
NME9	NME/NM23 family member 9
AMIGO2	adhesion molecule with Ig like domain 2
CEACAM16	carcinoembryonic antigen related cell adhesion molecule 16
LHFPL2	lipoma HMGIC fusion partner-like 2
RIMBP2	RIMS binding protein 2
SIDT2	SID1 transmembrane family member 2
CDKN2A-AS1	CDKN2A antisense RNA 1 (head to head)
susceptibility protein NSG-x
MS4A4A	membrane spanning 4-domains A4A
ZCWPW1	zinc finger CW-type and PWWP domain containing 1
PLEKHG1	pleckstrin homology and RhoGEF domain containing G1
VAT1L	vesicle amine transport 1 like
TTLL7	tubulin tyrosine ligase like 7
ECHDC3	enoyl-CoA hydratase domain containing 3
TM2D3	TM2 domain containing 3
SP6	Sp6 transcription factor
BHLHB9	basic helix-loop-helix family member b9
RNFT2	ring finger protein, transmembrane 2
FANCD2OS	FANCD2 opposite strand
ANO4	anoctamin 4
TDRD10	tudor domain containing 10
SHE	Src homology 2 domain containing E
MROH8	maestro heat like repeat family member 8
STARD6	StAR related lipid transfer domain containing 6
ZNF320	zinc finger protein 320
PLPP4	phospholipid phosphatase 4
SLC44A5	solute carrier family 44 member 5
MS4A6E	membrane spanning 4-domains A6E
PPP1R37	protein phosphatase 1 regulatory subunit 37
C5orf64	chromosome 5 open reading frame 64
This locus is considered non-coding by other groups due to a lack of experimental support for the protein, but NCBI annotates the protein because it meets minimal RefSeq quality criteria for representation. The coding status remains uncertain. [19 Nov 2014]
EPHA1-AS1	EPHA1 antisense RNA 1
EPHA1 antisense RNA 1 (non-protein coding)
SCIMP	SLP adaptor and CSK interacting membrane protein
LINC01567	long intergenic non-protein coding RNA 1567
MS4A4E	membrane spanning 4-domains A4E
LINC01184	long intergenic non-protein coding RNA 1184
CTC-228N24.3
FAM72B	family with sequence similarity 72 member B
not in current annotation release
SNAR-I	small ILF3/NF90-associated RNA I
small ILF3/NF90-associated RNA 3
WTAPP1	Wilms tumor 1 associated protein pseudogene 1
LINC01848	long intergenic non-protein coding RNA 1848
MIR1275	microRNA 1275
PGAM5P1	PGAM family member 5, mitochondrial serine/threonine protein phosphatase pseudogene 1
phosphoglycerate mutase family member 5 pseudogene 1
ADAMTS9-AS2	ADAMTS9 antisense RNA 2
ADAMTS9 antisense RNA 2 (non-protein coding)	CTD-2230D16.1
LINC00423	long intergenic non-protein coding RNA 423
RNF219-AS1	RNF219 antisense RNA 1
POU4F1 antisense RNA 1 (non-protein coding)
LINC01080	long intergenic non-protein coding RNA 1080
Long intergenic noncoding RNA TCONS_00021856
LINC02141	long intergenic non-protein coding RNA 2141
LINC01725	long intergenic non-protein coding RNA 1725
LINC01492	long intergenic non-protein coding RNA 1492
LIPC-AS1	LIPC antisense RNA 1
MEF2C-AS1	MEF2C antisense RNA 1
CTC-454M9.1
MIR6843	microRNA 6843
microRNA mir-6843
